mean_coverage,region_length,error,chrom,start,end,gaps,custom_annotation,pct_gtr_20x,sample_id
0.0,118,none,1,17345355,17345473,"{20: [[17345356, 17345473]]}",SDHB.chr1.17345375.17345454,0,NTC
0.0,163,none,1,17349082,17349245,"{20: [[17349083, 17349245]]}",SDHB.chr1.17349102.17349226,0,NTC
0.0,142,none,1,17350447,17350589,"{20: [[17350448, 17350589]]}",SDHB.chr1.17350467.17350570,0,NTC
0.0,157,none,1,17354223,17354380,"{20: [[17354224, 17354380]]}",SDHB.chr1.17354243.17354361,0,NTC
0.0,177,none,1,17355074,17355251,"{20: [[17355075, 17355251]]}",SDHB.chr1.17355094.17355232,0,NTC
0.0,126,none,1,17359534,17359660,"{20: [[17359535, 17359660]]}",SDHB.chr1.17359554.17359641,0,NTC
0.0,168,none,1,17371235,17371403,"{20: [[17371236, 17371403]]}",SDHB.chr1.17371255.17371384,0,NTC
0.0,112,none,1,17380422,17380534,"{20: [[17380423, 17380534]]}",SDHB.chr1.17380442.17380515,0,NTC
0.0,172,none,1,45794957,45795129,"{20: [[45794958, 45795129]]}",MUTYH.chr1.45794977.45795110,0,NTC
0.0,82,none,1,45796167,45796249,"{20: [[45796168, 45796249]]}",MUTYH.chr1.45796187.45796230,0,NTC
0.0,193,none,1,45796833,45797026,"{20: [[45796834, 45797026]]}",MUTYH.chr1.45796853.45797007,0,NTC
0.0,177,none,1,45797071,45797248,"{20: [[45797072, 45797248]]}",MUTYH.chr1.45797091.45797229,0,NTC
0.0,229,none,1,45797312,45797541,"{20: [[45797313, 45797541]]}",MUTYH.chr1.45797332.45797522,0,NTC
0.0,104,none,1,45797674,45797778,"{20: [[45797675, 45797778]]}",MUTYH.chr1.45797694.45797759,0,NTC
0.0,185,none,1,45797817,45798002,"{20: [[45797818, 45798002]]}",MUTYH.chr1.45797837.45797983,0,NTC
0.0,138,none,1,45798042,45798180,"{20: [[45798043, 45798180]]}",MUTYH.chr1.45798062.45798161,0,NTC
0.0,154,none,1,45798225,45798379,"{20: [[45798226, 45798379]]}",MUTYH.chr1.45798245.45798360,0,NTC
0.0,112,none,1,45798414,45798526,"{20: [[45798415, 45798526]]}",MUTYH.chr1.45798434.45798507,0,NTC
0.0,82,none,1,45798569,45798651,"{20: [[45798570, 45798651]]}",MUTYH.chr1.45798589.45798632,0,NTC
0.0,114,none,1,45798748,45798862,"{20: [[45798749, 45798862]]}",MUTYH.chr1.45798768.45798843,0,NTC
0.0,80,none,1,45798936,45799016,"{20: [[45798937, 45799016]]}",MUTYH.chr1.45798956.45798997,0,NTC
0.0,231,none,1,45799064,45799295,"{20: [[45799065, 45799295]]}",MUTYH.chr1.45799084.45799276,0,NTC
0.0,161,none,1,45800042,45800203,"{20: [[45800043, 45800203]]}",MUTYH.chr1.45800062.45800184,0,NTC
0.0,76,none,1,45805870,45805946,"{20: [[45805871, 45805946]]}",MUTYH.chr1.45805890.45805927,0,NTC
0.0,171,none,1,193091310,193091481,"{20: [[193091311, 193091481]]}",CDC73.chr1.193091147.193091461,0,NTC
0.0,146,none,1,193094221,193094367,"{20: [[193094222, 193094367]]}",CDC73.chr1.193094242.193094347,0,NTC
0.0,110,none,1,193099283,193099393,"{20: [[193099284, 193099393]]}",CDC73.chr1.193099304.193099373,0,NTC
0.0,103,none,1,193104500,193104603,"{20: [[193104501, 193104603]]}",CDC73.chr1.193104521.193104583,0,NTC
0.0,93,none,1,193104646,193104739,"{20: [[193104647, 193104739]]}",CDC73.chr1.193104667.193104719,0,NTC
0.0,129,none,1,193107194,193107323,"{20: [[193107195, 193107323]]}",CDC73.chr1.193107215.193107303,0,NTC
0.0,257,none,1,193110959,193111216,"{20: [[193110960, 193111216]]}",CDC73.chr1.193110980.193111196,0,NTC
0.0,139,none,1,193116976,193117115,"{20: [[193116977, 193117115]]}",CDC73.chr1.193116997.193117095,0,NTC
0.0,119,none,1,193119413,193119532,"{20: [[193119414, 193119532]]}",CDC73.chr1.193119434.193119512,0,NTC
0.0,105,none,1,193121489,193121594,"{20: [[193121490, 193121594]]}",CDC73.chr1.193121510.193121574,0,NTC
0.0,98,none,1,193172904,193173002,"{20: [[193172905, 193173002]]}",CDC73.chr1.193172925.193172982,0,NTC
0.0,76,none,1,193181174,193181250,"{20: [[193181175, 193181250]]}",CDC73.chr1.193181195.193181230,0,NTC
0.0,128,none,1,193181499,193181627,"{20: [[193181500, 193181627]]}",CDC73.chr1.193181520.193181607,0,NTC
0.0,202,none,1,193202102,193202304,"{20: [[193202103, 193202304]]}",CDC73.chr1.193202123.193202284,0,NTC
0.0,141,none,1,193205365,193205506,"{20: [[193205366, 193205506]]}",CDC73.chr1.193205386.193205486,0,NTC
0.0,182,none,1,193218839,193219021,"{20: [[193218840, 193219021]]}",CDC73.chr1.193218860.193219001,0,NTC
0.0,77,none,1,193219785,193219862,"{20: [[193219786, 193219862]]}",CDC73.chr1.193219806.193223031,0,NTC
0.0,183,none,1,241661107,241661290,"{20: [[241661108, 241661290]]}",FH.chr1.241660903.241661270,0,NTC
0.0,194,none,1,241663716,241663910,"{20: [[241663717, 241663910]]}",FH.chr1.241663737.241663890,0,NTC
0.0,168,none,1,241665722,241665890,"{20: [[241665723, 241665890]]}",FH.chr1.241665743.241665870,0,NTC
0.0,244,none,1,241667321,241667565,"{20: [[241667322, 241667565]]}",FH.chr1.241667342.241667545,0,NTC
0.0,206,none,1,241669282,241669488,"{20: [[241669283, 241669488]]}",FH.chr1.241669303.241669468,0,NTC
0.0,223,none,1,241671882,241672105,"{20: [[241671883, 241672105]]}",FH.chr1.241671903.241672085,0,NTC
0.0,217,none,1,241675246,241675463,"{20: [[241675247, 241675463]]}",FH.chr1.241675267.241675443,0,NTC
0.0,151,none,1,241676882,241677033,"{20: [[241676883, 241677033]]}",FH.chr1.241676903.241677013,0,NTC
0.0,175,none,1,241680461,241680636,"{20: [[241680462, 241680636]]}",FH.chr1.241680482.241680616,0,NTC
0.0,172,none,1,241682870,241683042,"{20: [[241682871, 241683042]]}",FH.chr1.241682891.241683061,0,NTC
0.0,116,none,2,47596624,47596740,"{20: [[47596625, 47596740]]}",EPCAM.chr2.47596644.47596721,0,NTC
0.0,148,none,2,47600581,47600729,"{20: [[47600582, 47600729]]}",EPCAM.chr2.47600601.47600710,0,NTC
0.0,281,none,2,47600926,47601207,"{20: [[47600927, 47601207]]}",EPCAM.chr2.47600946.47601188,0,NTC
0.0,106,none,2,47602352,47602458,"{20: [[47602353, 47602458]]}",EPCAM.chr2.47602372.47602439,0,NTC
0.0,104,none,2,47604132,47604236,"{20: [[47604133, 47604236]]}",EPCAM.chr2.47604152.47604217,0,NTC
0.0,142,none,2,47606071,47606213,"{20: [[47606072, 47606213]]}",EPCAM.chr2.47606091.47606194,0,NTC
0.0,241,none,2,47606887,47607128,"{20: [[47606888, 47607128]]}",EPCAM.chr2.47606907.47607109,0,NTC
0.0,85,none,2,47612284,47612369,"{20: [[47612285, 47612369]]}",EPCAM.chr2.47612304.47612350,0,NTC
0.0,82,none,2,47613690,47613772,"{20: [[47613691, 47613772]]}",EPCAM.chr2.47613710.47613753,0,NTC
0.0,251,none,2,47630310,47630561,"{20: [[47630311, 47630561]]}",MSH2.chr2.47630330.47630542,0,NTC
0.0,195,none,2,47635519,47635714,"{20: [[47635520, 47635714]]}",MSH2.chr2.47635539.47635695,0,NTC
0.0,319,none,2,47637212,47637531,"{20: [[47637213, 47637531]]}",MSH2.chr2.47637232.47637512,0,NTC
0.0,187,none,2,47639532,47639719,"{20: [[47639533, 47639719]]}",MSH2.chr2.47639552.47639700,0,NTC
0.0,190,none,2,47641387,47641577,"{20: [[47641388, 47641577]]}",MSH2.chr2.47641407.47641558,0,NTC
0.0,174,none,2,47643414,47643588,"{20: [[47643415, 47643588]]}",MSH2.chr2.47643434.47643569,0,NTC
0.0,240,none,2,47656860,47657100,"{20: [[47656861, 47657100]]}",MSH2.chr2.47656880.47657081,0,NTC
0.0,150,none,2,47672666,47672816,"{20: [[47672667, 47672816]]}",MSH2.chr2.47672686.47672797,0,NTC
0.0,164,none,2,47690149,47690313,"{20: [[47690150, 47690313]]}",MSH2.chr2.47690169.47690294,0,NTC
0.0,191,none,2,47693776,47693967,"{20: [[47693777, 47693967]]}",MSH2.chr2.47693796.47693948,0,NTC
0.0,138,none,2,47698083,47698221,"{20: [[47698084, 47698221]]}",MSH2.chr2.47698103.47698202,0,NTC
0.0,286,none,2,47702143,47702429,"{20: [[47702144, 47702429]]}",MSH2.chr2.47702163.47702410,0,NTC
0.0,245,none,2,47703485,47703730,"{20: [[47703486, 47703730]]}",MSH2.chr2.47703505.47703711,0,NTC
0.0,288,none,2,47705390,47705678,"{20: [[47705391, 47705678]]}",MSH2.chr2.47705410.47705659,0,NTC
0.0,216,none,2,47707814,47708030,"{20: [[47707815, 47708030]]}",MSH2.chr2.47707834.47708011,0,NTC
0.0,211,none,2,47709897,47710108,"{20: [[47709898, 47710108]]}",MSH2.chr2.47709917.47710089,0,NTC
0.0,300,none,2,48010352,48010652,"{20: [[48010353, 48010652]]}",MSH6.chr2.48010372.48010633,0,NTC
0.0,237,none,2,48018045,48018282,"{20: [[48018046, 48018282]]}",MSH6.chr2.48018065.48018263,0,NTC
0.0,210,none,2,48023012,48023222,"{20: [[48023013, 48023222]]}",MSH6.chr2.48023032.48023203,0,NTC
0.0,2585,none,2,48025729,48028314,"{20: [[48025730, 48028314]]}",MSH6.chr2.48025749.48028295,0,NTC
0.0,306,none,2,48030538,48030844,"{20: [[48030539, 48030844]]}",MSH6.chr2.48030558.48030825,0,NTC
0.0,158,none,2,48032028,48032186,"{20: [[48032029, 48032186]]}",MSH6.chr2.48032048.48032167,0,NTC
0.0,130,none,2,48032736,48032866,"{20: [[48032737, 48032866]]}",MSH6.chr2.48032756.48032847,0,NTC
0.0,195,none,2,48033322,48033517,"{20: [[48033323, 48033517]]}",MSH6.chr2.48033342.48033498,0,NTC
0.0,240,none,2,48033570,48033810,"{20: [[48033571, 48033810]]}",MSH6.chr2.48033590.48033791,0,NTC
0.0,122,none,2,48033897,48034019,"{20: [[48033898, 48034019]]}",MSH6.chr2.48033917.48034000,0,NTC
0.0,348,none,2,96919525,96919873,"{20: [[96919526, 96919873]]}",TMEM127.chr2.96919545.96919854,0,NTC
0.0,205,none,2,96920550,96920755,"{20: [[96920551, 96920755]]}",TMEM127.chr2.96920570.96920736,0,NTC
0.0,284,none,2,96930855,96931139,"{20: [[96930856, 96931139]]}",TMEM127.chr2.96930875.96931120,0,NTC
0.0,380,none,3,10183511,10183891,"{20: [[10183512, 10183891]]}",VHL.chr3.10183531.10183872,0,NTC
0.0,163,none,3,10188177,10188340,"{20: [[10188178, 10188340]]}",VHL.chr3.10188197.10188321,0,NTC
0.0,219,none,3,10191450,10191669,"{20: [[10191451, 10191669]]}",VHL.chr3.10191470.10191650,0,NTC
0.0,156,none,3,37035018,37035174,"{20: [[37035019, 37035174]]}",MLH1.chr3.37035038.37035155,0,NTC
1.0,131,none,3,37038089,37038220,"{20: [[37038090, 37038220]]}",MLH1.chr3.37038109.37038201,0,NTC
0.0,139,none,3,37042425,37042564,"{20: [[37042426, 37042564]]}",MLH1.chr3.37042445.37042545,0,NTC
0.0,114,none,3,37045871,37045985,"{20: [[37045872, 37045985]]}",MLH1.chr3.37045891.37045966,0,NTC
0.0,113,none,3,37048461,37048574,"{20: [[37048462, 37048574]]}",MLH1.chr3.37048481.37048555,0,NTC
0.0,132,none,3,37050284,37050416,"{20: [[37050285, 37050416]]}",MLH1.chr3.37050304.37050397,0,NTC
0.0,83,none,3,37053290,37053373,"{20: [[37053291, 37053373]]}",MLH1.chr3.37053310.37053354,0,NTC
0.0,129,none,3,37053481,37053610,"{20: [[37053482, 37053610]]}",MLH1.chr3.37053501.37053591,0,NTC
0.0,153,none,3,37055902,37056055,"{20: [[37055903, 37056055]]}",MLH1.chr3.37055922.37056036,0,NTC
0.0,134,none,3,37058976,37059110,"{20: [[37058977, 37059110]]}",MLH1.chr3.37058996.37059091,0,NTC
0.0,194,none,3,37061780,37061974,"{20: [[37061781, 37061974]]}",MLH1.chr3.37061800.37061955,0,NTC
0.0,411,none,3,37067107,37067518,"{20: [[37067108, 37067518]]}",MLH1.chr3.37067127.37067499,0,NTC
0.0,189,none,3,37070254,37070443,"{20: [[37070255, 37070443]]}",MLH1.chr3.37070274.37070424,0,NTC
0.0,149,none,3,37081656,37081805,"{20: [[37081657, 37081805]]}",MLH1.chr3.37081676.37081786,0,NTC
0.0,104,none,3,37083738,37083842,"{20: [[37083739, 37083842]]}",MLH1.chr3.37083758.37083823,0,NTC
0.0,205,none,3,37088989,37089194,"{20: [[37088990, 37089194]]}",MLH1.chr3.37089009.37089175,0,NTC
0.0,133,none,3,37089987,37090120,"{20: [[37089988, 37090120]]}",MLH1.chr3.37090007.37090101,0,NTC
0.0,154,none,3,37090374,37090528,"{20: [[37090375, 37090528]]}",MLH1.chr3.37090394.37090509,0,NTC
0.0,208,none,3,37091956,37092164,"{20: [[37091957, 37092164]]}",MLH1.chr3.37091976.37092145,0,NTC
0.0,174,none,3,52436283,52436457,"{20: [[52436284, 52436457]]}",BAP1.chr3.52435029.52436437,0,NTC
0.0,113,none,3,52436597,52436710,"{20: [[52436598, 52436710]]}",BAP1.chr3.52436618.52436690,0,NTC
0.0,133,none,3,52436774,52436907,"{20: [[52436775, 52436907]]}",BAP1.chr3.52436795.52436887,0,NTC
0.0,201,none,3,52437133,52437334,"{20: [[52437134, 52437334]]}",BAP1.chr3.52437154.52437314,0,NTC
0.0,519,none,3,52437411,52437930,"{20: [[52437412, 52437930]]}",BAP1.chr3.52437432.52437910,0,NTC
0.0,174,none,3,52438448,52438622,"{20: [[52438449, 52438622]]}",BAP1.chr3.52438469.52438602,0,NTC
0.0,225,none,3,52439105,52439330,"{20: [[52439106, 52439330]]}",BAP1.chr3.52439126.52439310,0,NTC
0.0,188,none,3,52439760,52439948,"{20: [[52439761, 52439948]]}",BAP1.chr3.52439781.52439928,0,NTC
0.0,164,none,3,52440248,52440412,"{20: [[52440249, 52440412]]}",BAP1.chr3.52440269.52440392,0,NTC
0.0,119,none,3,52440824,52440943,"{20: [[52440825, 52440943]]}",BAP1.chr3.52440845.52440923,0,NTC
0.0,183,none,3,52441169,52441352,"{20: [[52441170, 52441352]]}",BAP1.chr3.52441190.52441332,0,NTC
0.0,102,none,3,52441394,52441496,"{20: [[52441395, 52441496]]}",BAP1.chr3.52441415.52441476,0,NTC
0.0,160,none,3,52441953,52442113,"{20: [[52441954, 52442113]]}",BAP1.chr3.52441974.52442093,0,NTC
0.0,173,none,3,52442469,52442642,"{20: [[52442470, 52442642]]}",BAP1.chr3.52442490.52442622,0,NTC
0.0,95,none,3,52443549,52443644,"{20: [[52443550, 52443644]]}",BAP1.chr3.52443570.52443624,0,NTC
0.0,70,none,3,52443709,52443779,"{20: [[52443710, 52443779]]}",BAP1.chr3.52443730.52443759,0,NTC
0.0,77,none,3,52443837,52443914,"{20: [[52443838, 52443914]]}",BAP1.chr3.52443858.52444366,0,NTC
0.0,175,none,5,112090567,112090742,"{20: [[112090568, 112090742]]}",APC.chr5.112090587.112090723,0,NTC
0.0,125,none,5,112102002,112102127,"{20: [[112102003, 112102127]]}",APC.chr5.112102022.112102108,0,NTC
0.0,242,none,5,112102865,112103107,"{20: [[112102866, 112103107]]}",APC.chr5.112102885.112103088,0,NTC
0.0,149,none,5,112111305,112111454,"{20: [[112111306, 112111454]]}",APC.chr5.112111325.112111435,0,NTC
0.0,154,none,5,112116466,112116620,"{20: [[112116467, 112116620]]}",APC.chr5.112116486.112116601,0,NTC
0.0,124,none,5,112128122,112128246,"{20: [[112128123, 112128246]]}",APC.chr5.112128142.112128227,0,NTC
0.0,145,none,5,112136955,112137100,"{20: [[112136956, 112137100]]}",APC.chr5.112136975.112137081,0,NTC
0.0,139,none,5,112151171,112151310,"{20: [[112151172, 112151310]]}",APC.chr5.112151191.112151291,0,NTC
0.0,419,none,5,112154642,112155061,"{20: [[112154643, 112155061]]}",APC.chr5.112154662.112155042,0,NTC
0.0,136,none,5,112157572,112157708,"{20: [[112157573, 112157708]]}",APC.chr5.112157592.112157689,0,NTC
0.0,180,none,5,112162784,112162964,"{20: [[112162785, 112162964]]}",APC.chr5.112162804.112162945,0,NTC
0.0,118,none,5,112163605,112163723,"{20: [[112163606, 112163723]]}",APC.chr5.112163625.112163704,0,NTC
0.0,157,none,5,112164532,112164689,"{20: [[112164533, 112164689]]}",APC.chr5.112164552.112164670,0,NTC
0.0,255,none,5,112170627,112170882,"{20: [[112170628, 112170882]]}",APC.chr5.112170647.112170863,0,NTC
0.0,6614,none,5,112173229,112179843,"{20: [[112173230, 112179843]]}",APC.chr5.112173249.112179824,0,NTC
0.0,184,none,7,6013009,6013193,"{20: [[6013010, 6013193]]}",PMS2.chr7.6013029.6013174,0,NTC
0.0,210,none,7,6017198,6017408,"{20: [[6017199, 6017408]]}",PMS2.chr7.6017218.6017389,0,NTC
0.0,141,none,7,6018206,6018347,"{20: [[6018207, 6018347]]}",PMS2.chr7.6018226.6018328,0,NTC
0.0,208,none,7,6022434,6022642,"{20: [[6022435, 6022642]]}",PMS2.chr7.6022454.6022623,0,NTC
0.0,902,none,7,6026369,6027271,"{20: [[6026370, 6027271]]}",PMS2.chr7.6026389.6027252,0,NTC
0.0,196,none,7,6029410,6029606,"{20: [[6029411, 6029606]]}",PMS2.chr7.6029430.6029587,0,NTC
0.0,125,none,7,6031583,6031708,"{20: [[6031584, 6031708]]}",PMS2.chr7.6031603.6031689,0,NTC
0.0,140,none,7,6035144,6035284,"{20: [[6035145, 6035284]]}",PMS2.chr7.6035164.6035265,0,NTC
0.0,138,none,7,6036936,6037074,"{20: [[6036937, 6037074]]}",PMS2.chr7.6036956.6037055,0,NTC
0.0,208,none,7,6038718,6038926,"{20: [[6038719, 6038926]]}",PMS2.chr7.6038738.6038907,0,NTC
0.0,224,none,7,6042063,6042287,"{20: [[6042064, 6042287]]}",PMS2.chr7.6042083.6042268,0,NTC
0.0,143,none,7,6043300,6043443,"{20: [[6043301, 6043443]]}",PMS2.chr7.6043320.6043424,0,NTC
0.0,127,none,7,6043582,6043709,"{20: [[6043583, 6043709]]}",PMS2.chr7.6043602.6043690,0,NTC
0.0,180,none,7,6045502,6045682,"{20: [[6045503, 6045682]]}",PMS2.chr7.6045522.6045663,0,NTC
0.0,63,none,7,6048607,6048670,"{20: [[6048608, 6048670]]}",PMS2.chr7.6048627.6048651,0,NTC
0.1008,1240,none,7,116339118,116340358,"{20: [[116339119, 116340358]]}",MET.chr7.116339118.116340358,0,NTC
0.0,232,none,7,116371701,116371933,"{20: [[116371702, 116371933]]}",MET.chr7.116371701.116371933,0,NTC
0.0,175,none,7,116379983,116380158,"{20: [[116379984, 116380158]]}",MET.chr7.116379983.116380158,0,NTC
0.0,214,none,7,116380885,116381099,"{20: [[116380886, 116381099]]}",MET.chr7.116380885.116381099,0,NTC
0.0,201,none,7,116395388,116395589,"{20: [[116395389, 116395589]]}",MET.chr7.116395388.116395589,0,NTC
0.0,143,none,7,116397470,116397613,"{20: [[116397471, 116397613]]}",MET.chr7.116397470.116397613,0,NTC
0.0,177,none,7,116397671,116397848,"{20: [[116397672, 116397848]]}",MET.chr7.116397671.116397848,0,NTC
0.0,202,none,7,116398492,116398694,"{20: [[116398493, 116398694]]}",MET.chr7.116398492.116398694,0,NTC
0.0,194,none,7,116399370,116399564,"{20: [[116399371, 116399564]]}",MET.chr7.116399370.116399564,0,NTC
0.0,259,none,7,116403083,116403342,"{20: [[116403084, 116403342]]}",MET.chr7.116403083.116403342,0,NTC
0.0,187,none,7,116409678,116409865,"{20: [[116409679, 116409865]]}",MET.chr7.116409678.116409865,0,NTC
0.0,197,none,7,116411531,116411728,"{20: [[116411532, 116411728]]}",MET.chr7.116411531.116411728,0,NTC
0.0,181,none,7,116411882,116412063,"{20: [[116411883, 116412063]]}",MET.chr7.116411882.116412063,0,NTC
0.0,271,none,7,116414914,116415185,"{20: [[116414915, 116415185]]}",MET.chr7.116414914.116415185,0,NTC
0.0,121,none,7,116417422,116417543,"{20: [[116417423, 116417543]]}",MET.chr7.116417422.116417543,0,NTC
0.0,222,none,7,116418809,116419031,"{20: [[116418810, 116419031]]}",MET.chr7.116418809.116419031,0,NTC
0.0,150,none,7,116422021,116422171,"{20: [[116422022, 116422171]]}",MET.chr7.116422021.116422171,0,NTC
0.0,206,none,7,116423337,116423543,"{20: [[116423338, 116423543]]}",MET.chr7.116423337.116423543,0,NTC
0.0,177,none,7,116435688,116435865,"{20: [[116435689, 116435865]]}",MET.chr7.116435688.116435865,0,NTC
0.0,278,none,7,116435920,116436198,"{20: [[116435921, 116436198]]}",MET.chr7.116435920.116436198,0,NTC
0.0,54,none,9,21968207,21968261,"{20: [[21968208, 21968261]]}",CDKN2A.chr9.21968227.21968242,0,NTC
0.0,347,none,9,21970880,21971227,"{20: [[21970881, 21971227]]}",CDKN2A.chr9.21970900.21971208,0,NTC
0.0,190,none,9,21974656,21974846,"{20: [[21974657, 21974846]]}",CDKN2A.chr9.21974676.21974827,0,NTC
0.0,233,none,9,21994117,21994350,"{20: [[21994118, 21994350]]}",CDKN2A.chr9.21994137.21994331,0,NTC
0.0,580,none,9,98209173,98209753,"{20: [[98209174, 98209753]]}",PTCH1.chr9.98209193.98209734,0,NTC
0.0,295,none,9,98211330,98211625,"{20: [[98211331, 98211625]]}",PTCH1.chr9.98211350.98211606,0,NTC
0.0,140,none,9,98212102,98212242,"{20: [[98212103, 98212242]]}",PTCH1.chr9.98212122.98212223,0,NTC
0.0,183,none,9,98215739,98215922,"{20: [[98215740, 98215922]]}",PTCH1.chr9.98215759.98215903,0,NTC
0.0,178,none,9,98218537,98218715,"{20: [[98218538, 98218715]]}",PTCH1.chr9.98218557.98218696,0,NTC
0.0,321,none,9,98220274,98220595,"{20: [[98220275, 98220595]]}",PTCH1.chr9.98220294.98220576,0,NTC
0.0,224,none,9,98221861,98222085,"{20: [[98221862, 98222085]]}",PTCH1.chr9.98221881.98222066,0,NTC
0.0,183,none,9,98224117,98224300,"{20: [[98224118, 98224300]]}",PTCH1.chr9.98224137.98224281,0,NTC
0.0,350,none,9,98229377,98229727,"{20: [[98229378, 98229727]]}",PTCH1.chr9.98229397.98229708,0,NTC
0.0,443,none,9,98231012,98231455,"{20: [[98231013, 98231455]]}",PTCH1.chr9.98231032.98231436,0,NTC
0.0,159,none,9,98232074,98232233,"{20: [[98232075, 98232233]]}",PTCH1.chr9.98232094.98232214,0,NTC
0.0,166,none,9,98238295,98238461,"{20: [[98238296, 98238461]]}",PTCH1.chr9.98238315.98238442,0,NTC
0.0,139,none,9,98239020,98239159,"{20: [[98239021, 98239159]]}",PTCH1.chr9.98239040.98239140,0,NTC
0.0,196,none,9,98239808,98240004,"{20: [[98239809, 98240004]]}",PTCH1.chr9.98239828.98239985,0,NTC
0.0,172,none,9,98240316,98240488,"{20: [[98240317, 98240488]]}",PTCH1.chr9.98240336.98240469,0,NTC
0.0,188,none,9,98241261,98241449,"{20: [[98241262, 98241449]]}",PTCH1.chr9.98241281.98241430,0,NTC
0.0,162,none,9,98242230,98242392,"{20: [[98242231, 98242392]]}",PTCH1.chr9.98242250.98242373,0,NTC
0.0,239,none,9,98242651,98242890,"{20: [[98242652, 98242890]]}",PTCH1.chr9.98242671.98242871,0,NTC
0.0,132,none,9,98244210,98244342,"{20: [[98244211, 98244342]]}",PTCH1.chr9.98244230.98244323,0,NTC
0.0,110,none,9,98244395,98244505,"{20: [[98244396, 98244505]]}",PTCH1.chr9.98244415.98244486,0,NTC
0.0,230,none,9,98247946,98248176,"{20: [[98247947, 98248176]]}",PTCH1.chr9.98247966.98248157,0,NTC
0.0,233,none,9,98268668,98268901,"{20: [[98268669, 98268901]]}",PTCH1.chr9.98268688.98268882,0,NTC
0.0,238,none,9,98278884,98279122,"{20: [[98278885, 98279122]]}",PTCH1.chr9.98278904.98279103,0,NTC
0.0,560,none,9,135771601,135772161,"{20: [[135771602, 135772161]]}",TSC1.chr9.135771621.135772142,0,NTC
0.0,202,none,9,135772550,135772752,"{20: [[135772551, 135772752]]}",TSC1.chr9.135772570.135772733,0,NTC
0.0,210,none,9,135772789,135772999,"{20: [[135772790, 135772999]]}",TSC1.chr9.135772809.135772998,0,NTC
0.0,163,none,9,135776081,135776244,"{20: [[135776082, 135776244]]}",TSC1.chr9.135776101.135776225,0,NTC
0.0,151,none,9,135776955,135777106,"{20: [[135776956, 135777106]]}",TSC1.chr9.135776975.135777087,0,NTC
0.0,223,none,9,135777971,135778194,"{20: [[135777972, 135778194]]}",TSC1.chr9.135777991.135778175,0,NTC
0.0,207,none,9,135779017,135779224,"{20: [[135779018, 135779224]]}",TSC1.chr9.135779037.135779205,0,NTC
0.0,84,none,9,135779777,135779861,"{20: [[135779778, 135779861]]}",TSC1.chr9.135779797.135779842,0,NTC
0.0,599,none,9,135780947,135781546,"{20: [[135780948, 135781546]]}",TSC1.chr9.135780967.135781527,0,NTC
0.0,145,none,9,135782097,135782242,"{20: [[135782098, 135782242]]}",TSC1.chr9.135782117.135782223,0,NTC
0.0,110,none,9,135782667,135782777,"{20: [[135782668, 135782777]]}",TSC1.chr9.135782687.135782758,0,NTC
0.0,162,none,9,135785937,135786099,"{20: [[135785938, 135786099]]}",TSC1.chr9.135785957.135786080,0,NTC
0.0,152,none,9,135786368,135786520,"{20: [[135786369, 135786520]]}",TSC1.chr9.135786388.135786501,0,NTC
0.0,156,none,9,135786819,135786975,"{20: [[135786820, 135786975]]}",TSC1.chr9.135786839.135786956,0,NTC
0.0,216,none,9,135787648,135787864,"{20: [[135787649, 135787864]]}",TSC1.chr9.135787668.135787845,0,NTC
0.0,114,none,9,135796729,135796843,"{20: [[135796730, 135796843]]}",TSC1.chr9.135796749.135796824,0,NTC
0.0,195,none,9,135797185,135797380,"{20: [[135797186, 135797380]]}",TSC1.chr9.135797205.135797361,0,NTC
0.0,185,none,9,135798714,135798899,"{20: [[135798715, 135798899]]}",TSC1.chr9.135798734.135798880,0,NTC
0.0,193,none,9,135800953,135801146,"{20: [[135800954, 135801146]]}",TSC1.chr9.135800973.135801127,0,NTC
0.0,144,none,9,135802567,135802711,"{20: [[135802568, 135802711]]}",TSC1.chr9.135802587.135802692,0,NTC
0.0,146,none,9,135804133,135804279,"{20: [[135804134, 135804279]]}",TSC1.chr9.135804153.135804260,0,NTC
0.0,113,none,10,43572686,43572799,"{20: [[43572687, 43572799]]}",RET.chr10.43572706.43572780,0,NTC
0.0,304,none,10,43595886,43596190,"{20: [[43595887, 43596190]]}",RET.chr10.43595906.43596171,0,NTC
0.0,328,none,10,43597769,43598097,"{20: [[43597770, 43598097]]}",RET.chr10.43597789.43598078,0,NTC
0.0,282,none,10,43600379,43600661,"{20: [[43600380, 43600661]]}",RET.chr10.43600399.43600642,0,NTC
0.0,236,none,10,43601803,43602039,"{20: [[43601804, 43602039]]}",RET.chr10.43601823.43602020,0,NTC
0.0,240,none,10,43604458,43604698,"{20: [[43604459, 43604698]]}",RET.chr10.43604478.43604679,0,NTC
0.0,299,none,10,43606634,43606933,"{20: [[43606635, 43606933]]}",RET.chr10.43606654.43606914,0,NTC
0.0,166,none,10,43607526,43607692,"{20: [[43607527, 43607692]]}",RET.chr10.43607546.43607673,0,NTC
0.0,151,none,10,43608280,43608431,"{20: [[43608281, 43608431]]}",RET.chr10.43608300.43608412,0,NTC
0.0,160,none,10,43608983,43609143,"{20: [[43608984, 43609143]]}",RET.chr10.43609003.43609124,0,NTC
0.0,297,none,10,43609907,43610204,"{20: [[43609908, 43610204]]}",RET.chr10.43609927.43610185,0,NTC
0.0,188,none,10,43612011,43612199,"{20: [[43612012, 43612199]]}",RET.chr10.43612031.43612180,0,NTC
0.0,148,none,10,43613800,43613948,"{20: [[43613801, 43613948]]}",RET.chr10.43613820.43613929,0,NTC
0.0,255,none,10,43614958,43615213,"{20: [[43614959, 43615213]]}",RET.chr10.43614978.43615194,0,NTC
0.0,163,none,10,43615508,43615671,"{20: [[43615509, 43615671]]}",RET.chr10.43615528.43615652,0,NTC
0.0,111,none,10,43617373,43617484,"{20: [[43617374, 43617484]]}",RET.chr10.43617393.43617465,0,NTC
0.0,178,none,10,43619098,43619276,"{20: [[43619099, 43619276]]}",RET.chr10.43619118.43619257,0,NTC
0.0,140,none,10,43620310,43620450,"{20: [[43620311, 43620450]]}",RET.chr10.43620330.43620431,0,NTC
0.0,188,none,10,43622002,43622190,"{20: [[43622003, 43622190]]}",RET.chr10.43622022.43622171,0,NTC
0.0,198,none,10,43623539,43623737,"{20: [[43623540, 43623737]]}",RET.chr10.43623559.43623718,0,NTC
0.0,107,none,10,88635755,88635862,"{20: [[88635756, 88635862]]}",BMPR1A.chr10.88635775.88635843,0,NTC
0.0,203,none,10,88649798,88650001,"{20: [[88649799, 88650001]]}",BMPR1A.chr10.88649818.88649982,0,NTC
0.0,143,none,10,88651863,88652006,"{20: [[88651864, 88652006]]}",BMPR1A.chr10.88651883.88651987,0,NTC
0.0,137,none,10,88659530,88659667,"{20: [[88659531, 88659667]]}",BMPR1A.chr10.88659550.88659648,0,NTC
0.0,140,none,10,88659763,88659903,"{20: [[88659764, 88659903]]}",BMPR1A.chr10.88659783.88659884,0,NTC
0.0,185,none,10,88671976,88672161,"{20: [[88671977, 88672161]]}",BMPR1A.chr10.88671996.88672142,0,NTC
0.0,233,none,10,88676870,88677103,"{20: [[88676871, 88677103]]}",BMPR1A.chr10.88676890.88677084,0,NTC
0.0,338,none,10,88678908,88679246,"{20: [[88678909, 88679246]]}",BMPR1A.chr10.88678928.88679227,0,NTC
0.0,216,none,10,88681256,88681472,"{20: [[88681257, 88681472]]}",BMPR1A.chr10.88681276.88681453,0,NTC
0.0,171,none,10,88683112,88683283,"{20: [[88683113, 88683283]]}",BMPR1A.chr10.88683132.88683264,0,NTC
0.0,166,none,10,88683330,88683496,"{20: [[88683331, 88683496]]}",BMPR1A.chr10.88683350.88683477,0,NTC
0.0,119,none,10,89624206,89624325,"{20: [[89624207, 89624325]]}",PTEN.chr10.89624226.89624306,0,NTC
0.0,125,none,10,89653761,89653886,"{20: [[89653762, 89653886]]}",PTEN.chr10.89653781.89653867,0,NTC
0.0,85,none,10,89685249,89685334,"{20: [[89685250, 89685334]]}",PTEN.chr10.89685269.89685315,0,NTC
0.0,84,none,10,89690782,89690866,"{20: [[89690783, 89690866]]}",PTEN.chr10.89690802.89690847,0,NTC
0.0,279,none,10,89692749,89693028,"{20: [[89692750, 89693028]]}",PTEN.chr10.89692769.89693009,0,NTC
0.0,182,none,10,89711854,89712036,"{20: [[89711855, 89712036]]}",PTEN.chr10.89711874.89712017,0,NTC
0.0,207,none,10,89717589,89717796,"{20: [[89717590, 89717796]]}",PTEN.chr10.89717609.89717777,0,NTC
0.0,265,none,10,89720630,89720895,"{20: [[89720631, 89720895]]}",PTEN.chr10.89720650.89720876,0,NTC
0.0,226,none,10,89725023,89725249,"{20: [[89725024, 89725249]]}",PTEN.chr10.89725043.89725230,0,NTC
0.0,222,none,10,104263889,104264111,"{20: [[104263890, 104264111]]}",SUFU.chr10.104263909.104264092,0,NTC
0.0,175,none,10,104268905,104269080,"{20: [[104268906, 104269080]]}",SUFU.chr10.104268925.104269061,0,NTC
0.0,177,none,10,104309706,104309883,"{20: [[104309707, 104309883]]}",SUFU.chr10.104309726.104309864,0,NTC
0.0,183,none,10,104352318,104352501,"{20: [[104352319, 104352501]]}",SUFU.chr10.104352338.104352482,0,NTC
0.0,126,none,10,104353372,104353498,"{20: [[104353373, 104353498]]}",SUFU.chr10.104353392.104353479,0,NTC
0.0,113,none,10,104353729,104353842,"{20: [[104353730, 104353842]]}",SUFU.chr10.104353749.104353823,0,NTC
0.0,194,none,10,104356876,104357070,"{20: [[104356877, 104357070]]}",SUFU.chr10.104356896.104357051,0,NTC
0.0,152,none,10,104359169,104359321,"{20: [[104359170, 104359321]]}",SUFU.chr10.104359189.104359302,0,NTC
0.0,175,none,10,104375004,104375179,"{20: [[104375005, 104375179]]}",SUFU.chr10.104375024.104375160,0,NTC
0.0,179,none,10,104377026,104377205,"{20: [[104377027, 104377205]]}",SUFU.chr10.104377046.104377186,0,NTC
0.0,109,none,10,104386911,104387020,"{20: [[104386912, 104387020]]}",SUFU.chr10.104386931.104387001,0,NTC
0.0,130,none,10,104389802,104389932,"{20: [[104389803, 104389932]]}",SUFU.chr10.104389822.104389913,0,NTC
0.0,162,none,11,32410583,32410745,"{20: [[32410584, 32410745]]}",WT1.chr11.32410604.32410725,0,NTC
0.0,133,none,11,32413497,32413630,"{20: [[32413498, 32413630]]}",WT1.chr11.32413518.32413610,0,NTC
0.0,130,none,11,32414191,32414321,"{20: [[32414192, 32414321]]}",WT1.chr11.32414212.32414301,0,NTC
0.0,191,none,11,32417782,32417973,"{20: [[32417783, 32417973]]}",WT1.chr11.32417803.32417953,0,NTC
0.0,137,none,11,32421473,32421610,"{20: [[32421474, 32421610]]}",WT1.chr11.32421494.32421590,0,NTC
0.0,91,none,11,32438015,32438106,"{20: [[32438016, 32438106]]}",WT1.chr11.32438036.32438086,0,NTC
0.0,118,none,11,32439102,32439220,"{20: [[32439103, 32439220]]}",WT1.chr11.32439123.32439200,0,NTC
0.0,143,none,11,32449481,32449624,"{20: [[32449482, 32449624]]}",WT1.chr11.32449502.32449604,0,NTC
0.0,163,none,11,32450022,32450185,"{20: [[32450023, 32450185]]}",WT1.chr11.32450043.32450165,0,NTC
0.0,686,region length error,11,32456225,32456926,"{20: [[32456226, 32456911]]}",WT1.chr11.32456246.32456906,0,NTC
0.0,523,none,11,64571785,64572308,"{20: [[64571786, 64572308]]}",MEN1.chr11.64571805.64572289,0,NTC
0.0,205,none,11,64572485,64572690,"{20: [[64572486, 64572690]]}",MEN1.chr11.64572505.64572671,0,NTC
0.0,176,none,11,64573086,64573262,"{20: [[64573087, 64573262]]}",MEN1.chr11.64573106.64573243,0,NTC
0.0,177,none,11,64573683,64573860,"{20: [[64573684, 64573860]]}",MEN1.chr11.64573703.64573841,0,NTC
0.0,128,none,11,64574462,64574590,"{20: [[64574463, 64574590]]}",MEN1.chr11.64574482.64574571,0,NTC
0.0,81,none,11,64574630,64574711,"{20: [[64574631, 64574711]]}",MEN1.chr11.64574650.64574692,0,NTC
0.0,169,none,11,64575003,64575172,"{20: [[64575004, 64575172]]}",MEN1.chr11.64575023.64575153,0,NTC
0.0,249,none,11,64575342,64575591,"{20: [[64575343, 64575591]]}",MEN1.chr11.64575362.64575572,0,NTC
0.0,500,none,11,64577101,64577601,"{20: [[64577102, 64577601]]}",MEN1.chr11.64577121.64577582,0,NTC
0.0,92,none,11,111957611,111957703,"{20: [[111957612, 111957703]]}",SDHD.chr11.111957631.111957684,0,NTC
0.0,157,none,11,111958560,111958717,"{20: [[111958561, 111958717]]}",SDHD.chr11.111958580.111958698,0,NTC
0.0,185,none,11,111959570,111959755,"{20: [[111959571, 111959755]]}",SDHD.chr11.111959590.111959736,0,NTC
0.0,206,none,11,111965508,111965714,"{20: [[111965509, 111965714]]}",SDHD.chr11.111965528.111965695,0,NTC
0.0,133,none,12,58142287,58142420,"{20: [[58142288, 58142420]]}",CDK4.chr12.58142307.58142401,0,NTC
0.0,176,none,12,58142944,58143120,"{20: [[58142945, 58143120]]}",CDK4.chr12.58142964.58143101,0,NTC
0.0,91,none,12,58143216,58143307,"{20: [[58143217, 58143307]]}",CDK4.chr12.58143236.58143288,0,NTC
0.0,150,none,12,58144418,58144568,"{20: [[58144419, 58144568]]}",CDK4.chr12.58144438.58144549,0,NTC
0.0,208,none,12,58144685,58144893,"{20: [[58144686, 58144893]]}",CDK4.chr12.58144705.58144874,0,NTC
0.0,176,none,12,58144969,58145145,"{20: [[58144970, 58145145]]}",CDK4.chr12.58144989.58145126,0,NTC
0.0,258,none,12,58145262,58145520,"{20: [[58145263, 58145520]]}",CDK4.chr12.58145282.58145501,0,NTC
0.0,107,none,13,32890577,32890684,"{20: [[32890578, 32890684]]}",BRCA2.chr13.32890597.32890665,0,NTC
0.2076,289,none,13,32893193,32893482,"{20: [[32893194, 32893482]]}",BRCA2.chr13.32893213.32893463,0,NTC
0.0,149,none,13,32899192,32899341,"{20: [[32899193, 32899341]]}",BRCA2.chr13.32899212.32899322,0,NTC
0.0,90,none,13,32900217,32900307,"{20: [[32900218, 32900307]]}",BRCA2.chr13.32900237.32900288,0,NTC
0.0,81,none,13,32900358,32900439,"{20: [[32900359, 32900439]]}",BRCA2.chr13.32900378.32900420,0,NTC
0.0,155,none,13,32900615,32900770,"{20: [[32900616, 32900770]]}",BRCA2.chr13.32900635.32900751,0,NTC
0.0,90,none,13,32903559,32903649,"{20: [[32903560, 32903649]]}",BRCA2.chr13.32903579.32903630,0,NTC
0.0,152,none,13,32905035,32905187,"{20: [[32905036, 32905187]]}",BRCA2.chr13.32905055.32905168,0,NTC
0.0,1147,none,13,32906388,32907535,"{20: [[32906389, 32907535]]}",BRCA2.chr13.32906408.32907525,0,NTC
0.0,4972,none,13,32910381,32915353,"{20: [[32910382, 32915353]]}",BRCA2.chr13.32910401.32915334,0,NTC
0.0,136,none,13,32918674,32918810,"{20: [[32918675, 32918810]]}",BRCA2.chr13.32918694.32918791,0,NTC
0.0,110,none,13,32920943,32921053,"{20: [[32920944, 32921053]]}",BRCA2.chr13.32920963.32921034,0,NTC
0.0,468,none,13,32928977,32929445,"{20: [[32928978, 32929445]]}",BRCA2.chr13.32928997.32929426,0,NTC
0.0,222,none,13,32930544,32930766,"{20: [[32930545, 32930766]]}",BRCA2.chr13.32930564.32930747,0,NTC
0.0,228,none,13,32931858,32932086,"{20: [[32931859, 32932086]]}",BRCA2.chr13.32931878.32932067,0,NTC
0.0,211,none,13,32936639,32936850,"{20: [[32936640, 32936850]]}",BRCA2.chr13.32936659.32936831,0,NTC
0.0,395,none,13,32937295,32937690,"{20: [[32937296, 32937690]]}",BRCA2.chr13.32937315.32937671,0,NTC
0.0,196,none,13,32944518,32944714,"{20: [[32944519, 32944714]]}",BRCA2.chr13.32944538.32944695,0,NTC
0.0,185,none,13,32945072,32945257,"{20: [[32945073, 32945257]]}",BRCA2.chr13.32945092.32945238,0,NTC
0.0,162,none,13,32950786,32950948,"{20: [[32950787, 32950948]]}",BRCA2.chr13.32950806.32950929,0,NTC
0.0,239,none,13,32953433,32953672,"{20: [[32953434, 32953672]]}",BRCA2.chr13.32953453.32953653,0,NTC
0.0,204,none,13,32953866,32954070,"{20: [[32953867, 32954070]]}",BRCA2.chr13.32953886.32954051,0,NTC
0.0,179,none,13,32954123,32954302,"{20: [[32954124, 32954302]]}",BRCA2.chr13.32954143.32954283,0,NTC
0.0,285,none,13,32968805,32969090,"{20: [[32968806, 32969090]]}",BRCA2.chr13.32968825.32969071,0,NTC
0.0,187,none,13,32971014,32971201,"{20: [[32971015, 32971201]]}",BRCA2.chr13.32971034.32971182,0,NTC
0.0,649,none,13,32972278,32972927,"{20: [[32972279, 32972927]]}",BRCA2.chr13.32972298.32972908,0,NTC
0.0,228,none,14,65543173,65543401,"{20: [[65543174, 65543401]]}",MAX.chr14.65543193.65543382,0,NTC
0.0,164,none,14,65544610,65544774,"{20: [[65544611, 65544774]]}",MAX.chr14.65544630.65544755,0,NTC
0.0,148,none,14,65560405,65560553,"{20: [[65560406, 65560553]]}",MAX.chr14.65560425.65560534,0,NTC
0.0,67,none,14,65568243,65568310,"{20: [[65568244, 65568310]]}",MAX.chr14.65568263.65568291,0,NTC
0.0,76,none,14,65569001,65569077,"{20: [[65569002, 65569077]]}",MAX.chr14.65569021.65569058,0,NTC
0.0,206,none,14,95556814,95557020,"{20: [[95556815, 95557020]]}",DICER1.chr14.95556834.95557001,0,NTC
0.0,116,none,14,95557350,95557466,"{20: [[95557351, 95557466]]}",DICER1.chr14.95557370.95557447,0,NTC
0.0,203,none,14,95557519,95557722,"{20: [[95557520, 95557722]]}",DICER1.chr14.95557539.95557703,0,NTC
0.0,309,none,14,95560204,95560513,"{20: [[95560205, 95560513]]}",DICER1.chr14.95560224.95560494,0,NTC
0.0,929,none,14,95562141,95563070,"{20: [[95562142, 95563070]]}",DICER1.chr14.95562161.95563051,0,NTC
0.0,196,none,14,95566096,95566292,"{20: [[95566097, 95566292]]}",DICER1.chr14.95566116.95566273,0,NTC
0.0,821,none,14,95569662,95570483,"{20: [[95569663, 95570483]]}",DICER1.chr14.95569682.95570464,0,NTC
0.0,216,none,14,95571387,95571603,"{20: [[95571388, 95571603]]}",DICER1.chr14.95571407.95571584,0,NTC
0.0,146,none,14,95571994,95572140,"{20: [[95571995, 95572140]]}",DICER1.chr14.95572014.95572121,0,NTC
0.0,223,none,14,95572357,95572580,"{20: [[95572358, 95572580]]}",DICER1.chr14.95572377.95572561,0,NTC
0.0,194,none,14,95573924,95574118,"{20: [[95573925, 95574118]]}",DICER1.chr14.95573944.95574099,0,NTC
0.0,254,none,14,95574196,95574450,"{20: [[95574197, 95574450]]}",DICER1.chr14.95574216.95574431,0,NTC
0.0,220,none,14,95574640,95574860,"{20: [[95574641, 95574860]]}",DICER1.chr14.95574660.95574841,0,NTC
0.0,180,none,14,95577633,95577813,"{20: [[95577634, 95577813]]}",DICER1.chr14.95577653.95577794,0,NTC
0.0,116,none,14,95578488,95578604,"{20: [[95578489, 95578604]]}",DICER1.chr14.95578508.95578585,0,NTC
0.0,173,none,14,95579408,95579581,"{20: [[95579409, 95579581]]}",DICER1.chr14.95579428.95579562,0,NTC
0.0,195,none,14,95581983,95582178,"{20: [[95581984, 95582178]]}",DICER1.chr14.95582003.95582159,0,NTC
0.0,283,none,14,95582769,95583052,"{20: [[95582770, 95583052]]}",DICER1.chr14.95582789.95583033,0,NTC
0.0,173,none,14,95583938,95584111,"{20: [[95583939, 95584111]]}",DICER1.chr14.95583958.95584092,0,NTC
0.0,513,none,14,95590512,95591025,"{20: [[95590513, 95591025]]}",DICER1.chr14.95590532.95591006,0,NTC
0.0,209,none,14,95592896,95593105,"{20: [[95592897, 95593105]]}",DICER1.chr14.95592916.95593086,0,NTC
0.0,201,none,14,95595788,95595989,"{20: [[95595789, 95595989]]}",DICER1.chr14.95595808.95595970,0,NTC
0.0,175,none,14,95596374,95596549,"{20: [[95596375, 95596549]]}",DICER1.chr14.95596394.95596530,0,NTC
0.0,171,none,14,95597825,95597996,"{20: [[95597826, 95597996]]}",DICER1.chr14.95597845.95597977,0,NTC
0.0,203,none,14,95598831,95599034,"{20: [[95598832, 95599034]]}",DICER1.chr14.95598851.95599015,0,NTC
0.0,184,none,14,95599631,95599815,"{20: [[95599632, 95599815]]}",DICER1.chr14.95599651.95599796,0,NTC
0.0,178,none,16,2098596,2098774,"{20: [[2098597, 2098774]]}",TSC2.chr16.2098616.2098755,0,NTC
0.0,127,none,16,2100380,2100507,"{20: [[2100381, 2100507]]}",TSC2.chr16.2100400.2100488,0,NTC
0.0,151,none,16,2103322,2103473,"{20: [[2103323, 2103473]]}",TSC2.chr16.2103342.2103454,0,NTC
0.0,185,none,16,2104276,2104461,"{20: [[2104277, 2104461]]}",TSC2.chr16.2104296.2104442,0,NTC
0.0,158,none,16,2105382,2105540,"{20: [[2105383, 2105540]]}",TSC2.chr16.2105402.2105521,0,NTC
0.0,89,none,16,2106176,2106265,"{20: [[2106177, 2106265]]}",TSC2.chr16.2106196.2106246,0,NTC
0.0,166,none,16,2106624,2106790,"{20: [[2106625, 2106790]]}",TSC2.chr16.2106644.2106771,0,NTC
0.0,114,none,16,2107085,2107199,"{20: [[2107086, 2107199]]}",TSC2.chr16.2107105.2107180,0,NTC
0.0,167,none,16,2108727,2108894,"{20: [[2108728, 2108894]]}",TSC2.chr16.2108747.2108875,0,NTC
0.0,184,none,16,2110650,2110834,"{20: [[2110651, 2110834]]}",TSC2.chr16.2110670.2110815,0,NTC
0.0,178,none,16,2111851,2112029,"{20: [[2111852, 2112029]]}",TSC2.chr16.2111871.2112010,0,NTC
0.0,144,none,16,2112477,2112621,"{20: [[2112478, 2112621]]}",TSC2.chr16.2112497.2112602,0,NTC
0.0,122,none,16,2112952,2113074,"{20: [[2112953, 2113074]]}",TSC2.chr16.2112972.2113055,0,NTC
0.0,196,none,16,2114252,2114448,"{20: [[2114253, 2114448]]}",TSC2.chr16.2114272.2114429,0,NTC
0.0,157,none,16,2115499,2115656,"{20: [[2115500, 2115656]]}",TSC2.chr16.2115519.2115637,0,NTC
0.0,163,none,16,2120436,2120599,"{20: [[2120437, 2120599]]}",TSC2.chr16.2120456.2120580,0,NTC
0.7143,147,none,16,2121490,2121637,"{20: [[2121491, 2121637]]}",TSC2.chr16.2121510.2121618,0,NTC
0.0,191,none,16,2121764,2121955,"{20: [[2121765, 2121955]]}",TSC2.chr16.2121784.2121936,0,NTC
0.0,163,none,16,2122221,2122384,"{20: [[2122222, 2122384]]}",TSC2.chr16.2122241.2122365,0,NTC
0.0,175,none,16,2122829,2123004,"{20: [[2122830, 2123004]]}",TSC2.chr16.2122849.2122985,0,NTC
0.0,230,none,16,2124180,2124410,"{20: [[2124181, 2124410]]}",TSC2.chr16.2124200.2124391,0,NTC
0.0,134,none,16,2125779,2125913,"{20: [[2125780, 2125913]]}",TSC2.chr16.2125799.2125894,0,NTC
0.0,143,none,16,2126048,2126191,"{20: [[2126049, 2126191]]}",TSC2.chr16.2126068.2126172,0,NTC
0.0,135,none,16,2126471,2126606,"{20: [[2126472, 2126606]]}",TSC2.chr16.2126491.2126587,0,NTC
0.0,169,none,16,2127578,2127747,"{20: [[2127579, 2127747]]}",TSC2.chr16.2127598.2127728,0,NTC
0.0,205,none,16,2129012,2129217,"{20: [[2129013, 2129217]]}",TSC2.chr16.2129032.2129198,0,NTC
0.0,193,none,16,2129256,2129449,"{20: [[2129257, 2129449]]}",TSC2.chr16.2129276.2129430,0,NTC
0.0,153,none,16,2129537,2129690,"{20: [[2129538, 2129690]]}",TSC2.chr16.2129557.2129671,0,NTC
0.0,253,none,16,2130145,2130398,"{20: [[2130146, 2130398]]}",TSC2.chr16.2130165.2130379,0,NTC
0.0,244,none,16,2131575,2131819,"{20: [[2131576, 2131819]]}",TSC2.chr16.2131595.2131800,0,NTC
0.0,109,none,16,2132416,2132525,"{20: [[2132417, 2132525]]}",TSC2.chr16.2132436.2132506,0,NTC
0.0,162,none,16,2133675,2133837,"{20: [[2133676, 2133837]]}",TSC2.chr16.2133695.2133818,0,NTC
0.0,528,none,16,2134208,2134736,"{20: [[2134209, 2134736]]}",TSC2.chr16.2134228.2134717,0,NTC
0.0,116,none,16,2134931,2135047,"{20: [[2134932, 2135047]]}",TSC2.chr16.2134951.2135028,0,NTC
0.0,133,none,16,2135210,2135343,"{20: [[2135211, 2135343]]}",TSC2.chr16.2135230.2135324,0,NTC
0.0,227,none,16,2136173,2136400,"{20: [[2136174, 2136400]]}",TSC2.chr16.2136193.2136381,0,NTC
0.0,180,none,16,2136712,2136892,"{20: [[2136713, 2136892]]}",TSC2.chr16.2136732.2136873,0,NTC
0.0,119,none,16,2137843,2137962,"{20: [[2137844, 2137962]]}",TSC2.chr16.2137863.2137943,0,NTC
0.0,132,none,16,2138028,2138160,"{20: [[2138029, 2138160]]}",TSC2.chr16.2138048.2138141,0,NTC
0.0,139,none,16,2138207,2138346,"{20: [[2138208, 2138346]]}",TSC2.chr16.2138227.2138327,0,NTC
0.0,205,none,16,2138426,2138631,"{20: [[2138427, 2138631]]}",TSC2.chr16.2138446.2138612,0,NTC
0.0,251,none,16,23614759,23615010,"{20: [[23614760, 23615010]]}",PALB2.chr16.23614779.23614991,0,NTC
0.0,189,none,16,23619164,23619353,"{20: [[23619165, 23619353]]}",PALB2.chr16.23619184.23619334,0,NTC
0.0,128,none,16,23625304,23625432,"{20: [[23625305, 23625432]]}",PALB2.chr16.23625324.23625413,0,NTC
0.0,157,none,16,23632662,23632819,"{20: [[23632663, 23632819]]}",PALB2.chr16.23632682.23632800,0,NTC
0.0,202,none,16,23634269,23634471,"{20: [[23634270, 23634471]]}",PALB2.chr16.23634289.23634452,0,NTC
0.0,126,none,16,23635309,23635435,"{20: [[23635310, 23635435]]}",PALB2.chr16.23635329.23635416,0,NTC
0.0,202,none,16,23637536,23637738,"{20: [[23637537, 23637738]]}",PALB2.chr16.23637556.23637719,0,NTC
0.0,112,none,16,23640504,23640616,"{20: [[23640505, 23640616]]}",PALB2.chr16.23640524.23640597,0,NTC
0.0,870,none,16,23640940,23641810,"{20: [[23640941, 23641810]]}",PALB2.chr16.23640960.23641791,0,NTC
0.0,1513,none,16,23646162,23647675,"{20: [[23646163, 23647675]]}",PALB2.chr16.23646182.23647656,0,NTC
0.0,143,none,16,23649150,23649293,"{20: [[23649151, 23649293]]}",PALB2.chr16.23649170.23649274,0,NTC
0.0,100,none,16,23649370,23649470,"{20: [[23649371, 23649470]]}",PALB2.chr16.23649390.23649451,0,NTC
0.0,88,none,16,23652410,23652498,"{20: [[23652411, 23652498]]}",PALB2.chr16.23652430.23652479,0,NTC
0.0,88,none,16,68771298,68771386,"{20: [[68771299, 68771386]]}",CDH1.chr16.68771318.68771367,0,NTC
0.0,155,none,16,68772179,68772334,"{20: [[68772180, 68772334]]}",CDH1.chr16.68772199.68772315,0,NTC
0.0,264,none,16,68835552,68835816,"{20: [[68835553, 68835816]]}",CDH1.chr16.68835572.68835797,0,NTC
0.0,184,none,16,68842306,68842490,"{20: [[68842307, 68842490]]}",CDH1.chr16.68842326.68842471,0,NTC
0.0,196,none,16,68842575,68842771,"{20: [[68842576, 68842771]]}",CDH1.chr16.68842595.68842752,0,NTC
0.0,185,none,16,68844079,68844264,"{20: [[68844080, 68844264]]}",CDH1.chr16.68844099.68844245,0,NTC
0.0,216,none,16,68845566,68845782,"{20: [[68845567, 68845782]]}",CDH1.chr16.68845586.68845763,0,NTC
0.0,169,none,16,68846017,68846186,"{20: [[68846018, 68846186]]}",CDH1.chr16.68846037.68846167,0,NTC
0.0,223,none,16,68847195,68847418,"{20: [[68847196, 68847418]]}",CDH1.chr16.68847215.68847399,0,NTC
0.0,285,none,16,68849397,68849682,"{20: [[68849398, 68849682]]}",CDH1.chr16.68849417.68849663,0,NTC
0.0,186,none,16,68853162,68853348,"{20: [[68853163, 68853348]]}",CDH1.chr16.68853182.68853329,0,NTC
0.0,265,none,16,68855883,68856148,"{20: [[68855884, 68856148]]}",CDH1.chr16.68855903.68856129,0,NTC
0.0,268,none,16,68857281,68857549,"{20: [[68857282, 68857549]]}",CDH1.chr16.68857301.68857530,0,NTC
0.0,171,none,16,68862056,68862227,"{20: [[68862057, 68862227]]}",CDH1.chr16.68862076.68862208,0,NTC
0.0,184,none,16,68863536,68863720,"{20: [[68863537, 68863720]]}",CDH1.chr16.68863556.68863701,0,NTC
0.0,250,none,16,68867172,68867422,"{20: [[68867173, 68867422]]}",CDH1.chr16.68867192.68867403,0,NTC
0.0,122,none,17,7572906,7573028,"{20: [[7572907, 7573028]]}",TP53.chr17.7572926.7573009,0,NTC
0.0,147,none,17,7573906,7574053,"{20: [[7573907, 7574053]]}",TP53.chr17.7573926.7574034,0,NTC
0.0,114,none,17,7576832,7576946,"{20: [[7576833, 7576946]]}",TP53.chr17.7576852.7576927,0,NTC
0.0,177,none,17,7576998,7577175,"{20: [[7576999, 7577175]]}",TP53.chr17.7577018.7577156,0,NTC
0.0,150,none,17,7577478,7577628,"{20: [[7577479, 7577628]]}",TP53.chr17.7577498.7577609,0,NTC
0.0,153,none,17,7578156,7578309,"{20: [[7578157, 7578309]]}",TP53.chr17.7578176.7578290,0,NTC
0.0,224,none,17,7578350,7578574,"{20: [[7578351, 7578574]]}",TP53.chr17.7578370.7578555,0,NTC
0.0,319,none,17,7579291,7579610,"{20: [[7579292, 7579610]]}",TP53.chr17.7579311.7579591,0,NTC
0.0,62,none,17,7579679,7579741,"{20: [[7579680, 7579741]]}",TP53.chr17.7579699.7579722,0,NTC
0.0,114,none,17,7579818,7579932,"{20: [[7579819, 7579932]]}",TP53.chr17.7579838.7579913,0,NTC
0.0,242,none,17,17116948,17117190,"{20: [[17116949, 17117190]]}",FLCN.chr17.17116948.17117190,0,NTC
0.0,146,none,17,17118278,17118424,"{20: [[17118279, 17118424]]}",FLCN.chr17.17118278.17118424,0,NTC
0.0,172,none,17,17118478,17118650,"{20: [[17118479, 17118650]]}",FLCN.chr17.17118478.17118650,0,NTC
0.0,164,none,17,17119673,17119837,"{20: [[17119674, 17119837]]}",FLCN.chr17.17119673.17119837,0,NTC
0.0,154,none,17,17120362,17120516,"{20: [[17120363, 17120516]]}",FLCN.chr17.17120362.17120516,0,NTC
0.0,231,none,17,17122312,17122543,"{20: [[17122313, 17122543]]}",FLCN.chr17.17122312.17122543,0,NTC
0.0,132,none,17,17124830,17124962,"{20: [[17124831, 17124962]]}",FLCN.chr17.17124830.17124962,0,NTC
0.0,201,none,17,17125794,17125995,"{20: [[17125795, 17125995]]}",FLCN.chr17.17125794.17125995,0,NTC
0.0,262,none,17,17127215,17127477,"{20: [[17127216, 17127477]]}",FLCN.chr17.17127215.17127477,0,NTC
0.0,187,none,17,17129469,17129656,"{20: [[17129470, 17129656]]}",FLCN.chr17.17129469.17129656,0,NTC
0.0,289,none,17,17131182,17131471,"{20: [[17131183, 17131471]]}",FLCN.chr17.17131182.17131471,0,NTC
0.0,100,none,17,29422307,29422407,"{20: [[29422308, 29422407]]}",NF1.chr17.29422327.29422388,0,NTC
0.0,184,none,17,29482980,29483164,"{20: [[29482981, 29483164]]}",NF1.chr17.29483000.29483145,0,NTC
0.0,124,none,17,29486007,29486131,"{20: [[29486008, 29486131]]}",NF1.chr17.29486027.29486112,0,NTC
0.0,231,none,17,29490183,29490414,"{20: [[29490184, 29490414]]}",NF1.chr17.29490203.29490395,0,NTC
0.0,147,none,17,29496888,29497035,"{20: [[29496889, 29497035]]}",NF1.chr17.29496908.29497016,0,NTC
0.6389,108,none,17,29508419,29508527,"{20: [[29508420, 29508527]]}",NF1.chr17.29508439.29508508,0,NTC
0.0,116,none,17,29508707,29508823,"{20: [[29508708, 29508823]]}",NF1.chr17.29508727.29508804,0,NTC
0.0,198,none,17,29509505,29509703,"{20: [[29509506, 29509703]]}",NF1.chr17.29509525.29509684,0,NTC
0.0,214,none,17,29527419,29527633,"{20: [[29527420, 29527633]]}",NF1.chr17.29527439.29527614,0,NTC
0.0,163,none,17,29528034,29528197,"{20: [[29528035, 29528197]]}",NF1.chr17.29528054.29528178,0,NTC
0.0,115,none,17,29528408,29528523,"{20: [[29528409, 29528523]]}",NF1.chr17.29528428.29528504,0,NTC
0.0,172,none,17,29533237,29533409,"{20: [[29533238, 29533409]]}",NF1.chr17.29533257.29533390,0,NTC
0.0,175,none,17,29541448,29541623,"{20: [[29541449, 29541623]]}",NF1.chr17.29541468.29541604,0,NTC
0.0,154,none,17,29546002,29546156,"{20: [[29546003, 29546156]]}",NF1.chr17.29546022.29546137,0,NTC
0.0,120,none,17,29548847,29548967,"{20: [[29548848, 29548967]]}",NF1.chr17.29548867.29548948,0,NTC
0.0,164,none,17,29550441,29550605,"{20: [[29550442, 29550605]]}",NF1.chr17.29550461.29550586,0,NTC
0.0,196,none,17,29552092,29552288,"{20: [[29552093, 29552288]]}",NF1.chr17.29552112.29552269,0,NTC
0.0,290,none,17,29553432,29553722,"{20: [[29553433, 29553722]]}",NF1.chr17.29553452.29553703,0,NTC
0.0,114,none,17,29554215,29554329,"{20: [[29554216, 29554329]]}",NF1.chr17.29554235.29554310,0,NTC
0.0,124,none,17,29554520,29554644,"{20: [[29554521, 29554644]]}",NF1.chr17.29554540.29554625,0,NTC
0.0,481,none,17,29556022,29556503,"{20: [[29556023, 29556503]]}",NF1.chr17.29556042.29556484,0,NTC
0.0,180,none,17,29556832,29557012,"{20: [[29556833, 29557012]]}",NF1.chr17.29556852.29556993,0,NTC
0.0,163,none,17,29557257,29557420,"{20: [[29557258, 29557420]]}",NF1.chr17.29557277.29557401,0,NTC
0.0,124,none,17,29557839,29557963,"{20: [[29557840, 29557963]]}",NF1.chr17.29557859.29557944,0,NTC
0.0,157,none,17,29559070,29559227,"{20: [[29559071, 29559227]]}",NF1.chr17.29559090.29559208,0,NTC
0.0,222,none,17,29559697,29559919,"{20: [[29559698, 29559919]]}",NF1.chr17.29559717.29559900,0,NTC
0.0,252,none,17,29559999,29560251,"{20: [[29560000, 29560251]]}",NF1.chr17.29560019.29560232,0,NTC
0.0,202,none,17,29562608,29562810,"{20: [[29562609, 29562810]]}",NF1.chr17.29562628.29562791,0,NTC
0.0,144,none,17,29562915,29563059,"{20: [[29562916, 29563059]]}",NF1.chr17.29562935.29563040,0,NTC
0.0,176,none,17,29575981,29576157,"{20: [[29575982, 29576157]]}",NF1.chr17.29576001.29576138,0,NTC
0.0,103,none,17,29579935,29580038,"{20: [[29579936, 29580038]]}",NF1.chr17.29579955.29580019,0,NTC
0.0,199,none,17,29585341,29585540,"{20: [[29585342, 29585540]]}",NF1.chr17.29585361.29585521,0,NTC
0.0,138,none,17,29586029,29586167,"{20: [[29586030, 29586167]]}",NF1.chr17.29586049.29586148,0,NTC
0.0,187,none,17,29587366,29587553,"{20: [[29587367, 29587553]]}",NF1.chr17.29587386.29587534,0,NTC
0.0,187,none,17,29588708,29588895,"{20: [[29588709, 29588895]]}",NF1.chr17.29588728.29588876,0,NTC
0.0,151,none,17,29592226,29592377,"{20: [[29592227, 29592377]]}",NF1.chr17.29592246.29592358,0,NTC
0.0,473,none,17,29652817,29653290,"{20: [[29652818, 29653290]]}",NF1.chr17.29652837.29653271,0,NTC
0.8425,381,none,17,29654496,29654877,"{20: [[29654497, 29654877]]}",NF1.chr17.29654516.29654858,0,NTC
0.0,243,none,17,29657293,29657536,"{20: [[29657294, 29657536]]}",NF1.chr17.29657313.29657517,0,NTC
0.0,234,none,17,29661835,29662069,"{20: [[29661836, 29662069]]}",NF1.chr17.29661855.29662050,0,NTC
0.0,181,none,17,29663330,29663511,"{20: [[29663331, 29663511]]}",NF1.chr17.29663350.29663492,0,NTC
0.0,320,none,17,29663632,29663952,"{20: [[29663633, 29663952]]}",NF1.chr17.29663652.29663933,0,NTC
0.0,255,none,17,29664365,29664620,"{20: [[29664366, 29664620]]}",NF1.chr17.29664385.29664601,0,NTC
0.0,102,none,17,29664816,29664918,"{20: [[29664817, 29664918]]}",NF1.chr17.29664836.29664899,0,NTC
0.0,155,none,17,29665022,29665177,"{20: [[29665023, 29665177]]}",NF1.chr17.29665042.29665158,0,NTC
0.0,142,none,17,29665701,29665843,"{20: [[29665702, 29665843]]}",NF1.chr17.29665721.29665824,0,NTC
0.0,181,none,17,29667502,29667683,"{20: [[29667503, 29667683]]}",NF1.chr17.29667522.29667664,0,NTC
0.0,167,none,17,29670006,29670173,"{20: [[29670007, 29670173]]}",NF1.chr17.29670026.29670154,0,NTC
0.0,172,none,17,29676117,29676289,"{20: [[29676118, 29676289]]}",NF1.chr17.29676137.29676270,0,NTC
0.0,176,none,17,29677180,29677356,"{20: [[29677181, 29677356]]}",NF1.chr17.29677200.29677337,0,NTC
0.0,198,none,17,29679254,29679452,"{20: [[29679255, 29679452]]}",NF1.chr17.29679274.29679433,0,NTC
0.0,163,none,17,29683457,29683620,"{20: [[29683458, 29683620]]}",NF1.chr17.29683477.29683601,0,NTC
0.0,171,none,17,29683957,29684128,"{20: [[29683958, 29684128]]}",NF1.chr17.29683977.29684109,0,NTC
0.0,141,none,17,29684266,29684407,"{20: [[29684267, 29684407]]}",NF1.chr17.29684286.29684388,0,NTC
0.0,183,none,17,29685477,29685660,"{20: [[29685478, 29685660]]}",NF1.chr17.29685497.29685641,0,NTC
0.0,87,none,17,29685966,29686053,"{20: [[29685967, 29686053]]}",NF1.chr17.29685986.29686034,0,NTC
0.0,257,none,17,29687484,29687741,"{20: [[29687485, 29687741]]}",NF1.chr17.29687504.29687722,0,NTC
0.0,183,none,17,29701010,29701193,"{20: [[29701011, 29701193]]}",NF1.chr17.29701030.29701174,0,NTC
0.0,124,none,17,33427951,33428075,"{20: [[33427952, 33428075]]}",RAD51D.chr17.33426811.33428055,0,NTC
0.0,205,none,17,33428199,33428404,"{20: [[33428200, 33428404]]}",RAD51D.chr17.33428220.33428384,0,NTC
0.0,111,none,17,33430252,33430363,"{20: [[33430253, 33430363]]}",RAD51D.chr17.33430273.33430343,0,NTC
0.0,131,none,17,33430452,33430583,"{20: [[33430453, 33430583]]}",RAD51D.chr17.33430473.33430563,0,NTC
0.0,136,none,17,33433384,33433520,"{20: [[33433385, 33433520]]}",RAD51D.chr17.33433405.33433500,0,NTC
0.0,175,none,17,33433986,33434161,"{20: [[33433987, 33434161]]}",RAD51D.chr17.33434007.33434141,0,NTC
0.0,122,none,17,33434364,33434486,"{20: [[33434365, 33434486]]}",RAD51D.chr17.33434385.33434466,0,NTC
0.0,159,none,17,33445499,33445658,"{20: [[33445500, 33445658]]}",RAD51D.chr17.33445520.33445638,0,NTC
0.0,102,none,17,33446109,33446211,"{20: [[33446110, 33446211]]}",RAD51D.chr17.33446130.33446191,0,NTC
0.0,122,none,17,33446530,33446652,"{20: [[33446531, 33446652]]}",RAD51D.chr17.33446551.33446888,0,NTC
0.0,165,none,17,41197674,41197839,"{20: [[41197675, 41197839]]}",BRCA1.chr17.41197694.41197820,0,NTC
0.0,101,none,17,41199639,41199740,"{20: [[41199640, 41199740]]}",BRCA1.chr17.41199659.41199721,0,NTC
0.0,114,none,17,41201117,41201231,"{20: [[41201118, 41201231]]}",BRCA1.chr17.41201137.41201212,0,NTC
0.0,95,none,17,41203059,41203154,"{20: [[41203060, 41203154]]}",BRCA1.chr17.41203079.41203135,0,NTC
0.0,124,none,17,41209048,41209172,"{20: [[41209049, 41209172]]}",BRCA1.chr17.41209068.41209153,0,NTC
0.0,81,none,17,41215329,41215410,"{20: [[41215330, 41215410]]}",BRCA1.chr17.41215349.41215391,0,NTC
0.0,118,none,17,41215870,41215988,"{20: [[41215871, 41215988]]}",BRCA1.chr17.41215890.41215969,0,NTC
0.0,128,none,17,41219604,41219732,"{20: [[41219605, 41219732]]}",BRCA1.chr17.41219624.41219713,0,NTC
0.0,351,none,17,41222924,41223275,"{20: [[41222925, 41223275]]}",BRCA1.chr17.41222944.41223256,0,NTC
0.0,231,none,17,41226327,41226558,"{20: [[41226328, 41226558]]}",BRCA1.chr17.41226347.41226539,0,NTC
0.0,167,none,17,41228484,41228651,"{20: [[41228485, 41228651]]}",BRCA1.chr17.41228504.41228632,0,NTC
0.0,212,none,17,41234400,41234612,"{20: [[41234401, 41234612]]}",BRCA1.chr17.41234420.41234593,0,NTC
0.0,129,none,17,41242940,41243069,"{20: [[41242941, 41243069]]}",BRCA1.chr17.41242960.41243050,0,NTC
0.0,3466,none,17,41243431,41246897,"{20: [[41243432, 41246897]]}",BRCA1.chr17.41243451.41246878,0,NTC
0.0,117,none,17,41247842,41247959,"{20: [[41247843, 41247959]]}",BRCA1.chr17.41247862.41247940,0,NTC
0.0,86,none,17,41249240,41249326,"{20: [[41249241, 41249326]]}",BRCA1.chr17.41249260.41249307,0,NTC
0.0,146,none,17,41251771,41251917,"{20: [[41251772, 41251917]]}",BRCA1.chr17.41251791.41251898,0,NTC
0.0,180,none,17,41256118,41256298,"{20: [[41256119, 41256298]]}",BRCA1.chr17.41256138.41256279,0,NTC
0.0,129,none,17,41256864,41256993,"{20: [[41256865, 41256993]]}",BRCA1.chr17.41256884.41256974,0,NTC
0.0,118,none,17,41258452,41258570,"{20: [[41258453, 41258570]]}",BRCA1.chr17.41258472.41258551,0,NTC
0.0,94,none,17,41267722,41267816,"{20: [[41267723, 41267816]]}",BRCA1.chr17.41267742.41267797,0,NTC
0.0,120,none,17,41276013,41276133,"{20: [[41276014, 41276133]]}",BRCA1.chr17.41276033.41276114,0,NTC
0.0,185,none,17,56769984,56770169,"{20: [[56769985, 56770169]]}",RAD51C.chr17.56769934.56770149,0,NTC
0.0,299,none,17,56772271,56772570,"{20: [[56772272, 56772570]]}",RAD51C.chr17.56772292.56772550,0,NTC
0.0,207,none,17,56774033,56774240,"{20: [[56774034, 56774240]]}",RAD51C.chr17.56774054.56774220,0,NTC
0.0,174,none,17,56780536,56780710,"{20: [[56780537, 56780710]]}",RAD51C.chr17.56780557.56780690,0,NTC
0.0,172,none,17,56787199,56787371,"{20: [[56787200, 56787371]]}",RAD51C.chr17.56787220.56787351,0,NTC
0.0,107,none,17,56798086,56798193,"{20: [[56798087, 56798193]]}",RAD51C.chr17.56798107.56798173,0,NTC
0.0,101,none,17,56801380,56801481,"{20: [[56801381, 56801481]]}",RAD51C.chr17.56801401.56801461,0,NTC
0.0,101,none,17,56809824,56809925,"{20: [[56809825, 56809925]]}",RAD51C.chr17.56809845.56809905,0,NTC
0.0,145,none,17,56811458,56811603,"{20: [[56811459, 56811603]]}",RAD51C.chr17.56811479.56811703,0,NTC
0.0,885,none,17,59760636,59761521,"{20: [[59760637, 59761521]]}",BRIP1.chr17.59758627.59761501,0,NTC
0.0,370,none,17,59763176,59763546,"{20: [[59763177, 59763546]]}",BRIP1.chr17.59763197.59763526,0,NTC
0.0,123,none,17,59770770,59770893,"{20: [[59770771, 59770893]]}",BRIP1.chr17.59770791.59770873,0,NTC
0.0,153,none,17,59793291,59793444,"{20: [[59793292, 59793444]]}",BRIP1.chr17.59793312.59793424,0,NTC
0.0,162,none,17,59820353,59820515,"{20: [[59820354, 59820515]]}",BRIP1.chr17.59820374.59820495,0,NTC
0.0,200,none,17,59821772,59821972,"{20: [[59821773, 59821972]]}",BRIP1.chr17.59821793.59821952,0,NTC
0.0,202,none,17,59853741,59853943,"{20: [[59853742, 59853943]]}",BRIP1.chr17.59853762.59853923,0,NTC
0.0,181,none,17,59857601,59857782,"{20: [[59857602, 59857782]]}",BRIP1.chr17.59857622.59857762,0,NTC
0.0,206,none,17,59858180,59858386,"{20: [[59858181, 59858386]]}",BRIP1.chr17.59858201.59858366,0,NTC
0.0,195,none,17,59861610,59861805,"{20: [[59861611, 59861805]]}",BRIP1.chr17.59861631.59861785,0,NTC
0.0,173,none,17,59870937,59871110,"{20: [[59870938, 59871110]]}",BRIP1.chr17.59870958.59871090,0,NTC
0.0,240,none,17,59876440,59876680,"{20: [[59876441, 59876680]]}",BRIP1.chr17.59876461.59876660,0,NTC
0.0,262,none,17,59878593,59878855,"{20: [[59878594, 59878855]]}",BRIP1.chr17.59878614.59878835,0,NTC
0.0,331,none,17,59885807,59886138,"{20: [[59885808, 59886138]]}",BRIP1.chr17.59885828.59886118,0,NTC
0.0,160,none,17,59924441,59924601,"{20: [[59924442, 59924601]]}",BRIP1.chr17.59924462.59924581,0,NTC
0.0,168,none,17,59926469,59926637,"{20: [[59926470, 59926637]]}",BRIP1.chr17.59926490.59926617,0,NTC
0.0,214,none,17,59934398,59934612,"{20: [[59934399, 59934612]]}",BRIP1.chr17.59934419.59934592,0,NTC
0.0,152,none,17,59937136,59937288,"{20: [[59937137, 59937288]]}",BRIP1.chr17.59937157.59937268,0,NTC
0.0,133,none,17,59938787,59938920,"{20: [[59938788, 59938920]]}",BRIP1.chr17.59938808.59938930,0,NTC
0.0,289,none,18,48573396,48573685,"{20: [[48573397, 48573685]]}",SMAD4.chr18.48573416.48573666,0,NTC
0.0,215,none,18,48575035,48575250,"{20: [[48575036, 48575250]]}",SMAD4.chr18.48575055.48575231,0,NTC
0.0,70,none,18,48575644,48575714,"{20: [[48575645, 48575714]]}",SMAD4.chr18.48575664.48575695,0,NTC
0.0,253,none,18,48581130,48581383,"{20: [[48581131, 48581383]]}",SMAD4.chr18.48581150.48581364,0,NTC
0.0,160,none,18,48584474,48584634,"{20: [[48584475, 48584634]]}",SMAD4.chr18.48584494.48584615,0,NTC
0.0,157,none,18,48584689,48584846,"{20: [[48584690, 48584846]]}",SMAD4.chr18.48584709.48584827,0,NTC
0.0,91,none,18,48586215,48586306,"{20: [[48586216, 48586306]]}",SMAD4.chr18.48586235.48586287,0,NTC
0.0,224,none,18,48591772,48591996,"{20: [[48591773, 48591996]]}",SMAD4.chr18.48591792.48591977,0,NTC
0.0,209,none,18,48593368,48593577,"{20: [[48593369, 48593577]]}",SMAD4.chr18.48593388.48593558,0,NTC
0.0,179,none,18,48602987,48603166,"{20: [[48602988, 48603166]]}",SMAD4.chr18.48603007.48603147,0,NTC
0.0,252,none,18,48604605,48604857,"{20: [[48604606, 48604857]]}",SMAD4.chr18.48604625.48604838,0,NTC
0.0,330,none,19,1206892,1207222,"{20: [[1206893, 1207222]]}",STK11.chr19.1206912.1207203,0,NTC
0.0,124,none,19,1218395,1218519,"{20: [[1218396, 1218519]]}",STK11.chr19.1218415.1218500,0,NTC
0.0,130,none,19,1219302,1219432,"{20: [[1219303, 1219432]]}",STK11.chr19.1219322.1219413,0,NTC
0.0,173,none,19,1220351,1220524,"{20: [[1220352, 1220524]]}",STK11.chr19.1220371.1220505,0,NTC
0.0,177,none,19,1220559,1220736,"{20: [[1220560, 1220736]]}",STK11.chr19.1220579.1220717,0,NTC
0.0,168,none,19,1221191,1221359,"{20: [[1221192, 1221359]]}",STK11.chr19.1221211.1221340,0,NTC
0.0,98,none,19,1221927,1222025,"{20: [[1221928, 1222025]]}",STK11.chr19.1221947.1222006,0,NTC
0.0,228,none,19,1222963,1223191,"{20: [[1222964, 1223191]]}",STK11.chr19.1222983.1223172,0,NTC
0.0,234,none,19,1226432,1226666,"{20: [[1226433, 1226666]]}",STK11.chr19.1226452.1226647,0,NTC
0.0,133,none,22,24129336,24129469,"{20: [[24129337, 24129469]]}",SMARCB1.chr22.24129356.24129450,0,NTC
0.0,179,none,22,24133922,24134101,"{20: [[24133923, 24134101]]}",SMARCB1.chr22.24133942.24134082,0,NTC
0.0,170,none,22,24135725,24135895,"{20: [[24135726, 24135895]]}",SMARCB1.chr22.24135745.24135876,0,NTC
0.3708,178,none,22,24143110,24143288,"{20: [[24143111, 24143288]]}",SMARCB1.chr22.24143130.24143269,0,NTC
0.0,168,none,22,24145461,24145629,"{20: [[24145462, 24145629]]}",SMARCB1.chr22.24145481.24145610,0,NTC
0.0,207,none,22,24158936,24159143,"{20: [[24158937, 24159143]]}",SMARCB1.chr22.24158956.24159124,0,NTC
0.0,231,none,22,24167391,24167622,"{20: [[24167392, 24167622]]}",SMARCB1.chr22.24167411.24167603,0,NTC
0.0,172,none,22,24175738,24175910,"{20: [[24175739, 24175910]]}",SMARCB1.chr22.24175758.24175891,0,NTC
0.0,80,none,22,24176307,24176387,"{20: [[24176308, 24176387]]}",SMARCB1.chr22.24176327.24176368,0,NTC
0.0,130,none,22,29083864,29083994,"{20: [[29083865, 29083994]]}",CHEK2,0,NTC
0.0,121,none,22,29085102,29085223,"{20: [[29085103, 29085223]]}",CHEK2,0,NTC
0.0,126,none,22,29089999,29090125,"{20: [[29090000, 29090125]]}",CHEK2,0,NTC
0.0,156,none,22,29091094,29091250,"{20: [[29091095, 29091250]]}",CHEK2,0,NTC
0.0,204,none,22,29091677,29091881,"{20: [[29091678, 29091881]]}",CHEK2,0,NTC
0.0,127,none,22,29092868,29092995,"{20: [[29092869, 29092995]]}",CHEK2,0,NTC
0.0,140,none,22,29095805,29095945,"{20: [[29095806, 29095945]]}",CHEK2,0,NTC
0.0,102,none,22,29099472,29099574,"{20: [[29099473, 29099574]]}",CHEK2,0,NTC
0.0,94,none,22,29105973,29106067,"{20: [[29105974, 29106067]]}",CHEK2,0,NTC
0.0,149,none,22,29107876,29108025,"{20: [[29107877, 29108025]]}",CHEK2,0,NTC
0.0,131,none,22,29115362,29115493,"{20: [[29115363, 29115493]]}",CHEK2,0,NTC
0.117,188,none,22,29120944,29121132,"{20: [[29120945, 29121132]]}",CHEK2,0,NTC
0.0,165,none,22,29121210,29121375,"{20: [[29121211, 29121375]]}",CHEK2,0,NTC
0.0,41,none,22,29129991,29130032,"{20: [[29129992, 29130032]]}",CHEK2,0,NTC
0.0,359,none,22,29130370,29130729,"{20: [[29130371, 29130729]]}",CHEK2,0,NTC
0.0,154,none,22,29999967,30000121,"{20: [[29999968, 30000121]]}",NF2.chr22.29999967.30000121,0,NTC
0.0,166,none,22,30032719,30032885,"{20: [[30032720, 30032885]]}",NF2.chr22.30032719.30032885,0,NTC
0.0,163,none,22,30035058,30035221,"{20: [[30035059, 30035221]]}",NF2.chr22.30035058.30035221,0,NTC
0.0,124,none,22,30038170,30038294,"{20: [[30038171, 30038294]]}",NF2.chr22.30038170.30038294,0,NTC
0.0,109,none,22,30050625,30050734,"{20: [[30050626, 30050734]]}",NF2.chr22.30050625.30050734,0,NTC
0.0,123,none,22,30051562,30051685,"{20: [[30051563, 30051685]]}",NF2.chr22.30051562.30051685,0,NTC
0.0,116,none,22,30054157,30054273,"{20: [[30054158, 30054273]]}",NF2.chr22.30054157.30054273,0,NTC
0.0,175,none,22,30057173,30057348,"{20: [[30057174, 30057348]]}",NF2.chr22.30057173.30057348,0,NTC
0.0,115,none,22,30060958,30061073,"{20: [[30060959, 30061073]]}",NF2.chr22.30060958.30061073,0,NTC
0.0,154,none,22,30064301,30064455,"{20: [[30064302, 30064455]]}",NF2.chr22.30064301.30064455,0,NTC
0.0,163,none,22,30067794,30067957,"{20: [[30067795, 30067957]]}",NF2.chr22.30067794.30067957,0,NTC
0.0,258,none,22,30069237,30069495,"{20: [[30069238, 30069495]]}",NF2.chr22.30069237.30069495,0,NTC
0.0,146,none,22,30070804,30070950,"{20: [[30070805, 30070950]]}",NF2.chr22.30070804.30070950,0,NTC
0.0,168,none,22,30074164,30074332,"{20: [[30074165, 30074332]]}",NF2.chr22.30074164.30074332,0,NTC
0.0,203,none,22,30077407,30077610,"{20: [[30077408, 30077610]]}",NF2.chr22.30077407.30077610,0,NTC
0.0,91,none,22,30090720,30090811,"{20: [[30090721, 30090811]]}",NF2.chr22.30090720.30090811,0,NTC
